WWWWWWWWWWWWWWWWWWWWWWWWWWWWWWWWWWWWWWWWWWWWWWWWWWWWWWWWWWWW
WWWWWWWWWWWWWWWWWWWWWWWWWWWWWWWWWWWWWWWWWWWWWWWWWWWWWWWWWWWW
WWWE WWWWWW     WWWWWW     WWWWWW   WWWWWW  BB   WWWWWWB WWW
WWW  E  WW        KWW         WW         WW        KWD D WWW
WWWWW      WWBWW      WW WW      WW WW      WW WW     DWWWWW
WWW  WW  WW DDD WW  WW     WW  WW     WW  WW     WW  WW  WWW
WWW    WW       K WW    W    WW    W    WW    W   KWW    WWW
WWW  WW  WW W W WW  WW     WW  WW     WW  WW     WW  WW  WWW
WWWWW      WW WW      WW WWDD   BWW WW      WW WW      WWWWW
WWW               WW         WW         WW               WWW
WWWWW      WW WW      WW WW      WWEWW      WW WW      DWWWW
WWW  WW  WWB    WW  WW     WW  WW     WW  WW     WW  WD KWWW
WWW    WW  DDW    WW    W    WW    W    WW    W    WD    WWW
WWW  WW  WW     WW  WW     WW  WW     WW  WW  B  WW  WD  WWW
WWWWW      WW WW      WW WW  DD  WW WW      WW WW      DWWWW
WWW               WW         WW    D    WW               WWW
WWWWW      WW WW      WW WW      WW WW      WW WW       WWWW
WWW  WW  WW    BWW  WW     WW  WW     WW  WW     WW  WW  WWW
WWW    WW    WDD  WW    W    WW    W    WW  DDW    W E   WWW
WWW  WW  WW     WW  WW     WWB WW     WW  WW     WW  WW  WWW
WWWWW    DDWW WW      WW WW  DD  WWEWW      WW WW       WWWW
WWWJ    WW         WW         WW         WW        WW    WWW
WWW  WWWWWW     WWWWWW     WWWWWW     WWWWWW     WWWWWW  WWW
WWW               D                     D                WWW
WWWWWWWWWWWWWWWWWWWWWWWWWWWWWWWWWWWWWWWWWWWWWWWWWWWWWWWWWWWW